###########
#ccccccccc#
#         #
#         #
#         #
#         #
#         #
#    P    #
###########
